8 29
.0#.*.####.***.##.**#..#..**.
..#**####***.##.##x#*.###..#.
..*.#****..#.*##.*.#*#......#
*#.*###.#.#*#*#*#*#..*#.***..
.**.*##.*...*.#...*###.#**##.
*###***##****#*###.##**..#..*
*..**#.***##..*....**.*#*#***
.**.**#.**.#.#*..*#.#.#.*#.#.
