10 24
**.**.##.**#*.#*##.#..#.
#*..#..#**#.##..*.*#.**#
#*#**#*..*.*.*.#.###**#*
**.#*...#**..*..#.*..**.
#****.*...*..***..*.#*..
*.*#**##*#.#*#..#*.#.#.#
*.*..###.#*#..*.###..#..
.*.*.*#..*#...*.*###.*#*
#0..#****#*.*#.#.##.#...
##**##.#*##x#.#*..#.**##
