6 12
***#..*.#*..
#*.#x.*.**.*
..**##.#..*#
*##..*.**#*#
0#****##.*#.
....*##..*##
