9 8
.##...#.
#...**.#
#**x*.*.
#*.#.*#*
*.**.**#
..**0#**
.*.*****
.**..**.
*.*****#
