18 20
#*.*....#.#.#..#.#.#
.#.#.#..#.###.##.***
...*.#.****.**.***.0
##....#....####....#
#*.*....#.#.#..#.#*#
....####...##....#*#
****************...#
.###############.#*#
.................***
...........#.#.####.
###.##.***##........
####...##.......****
*************....###
###############.....
######...........**.
.................*x.
....................
