10 20
#*.*....#.#.#..#.#.#
.#.#.#..#.###.##.***
...*.#.****.**.***.0
##....#....####...##
#*.*....#.#.#..#.#.#
....####...##....###
....................
******************.#
##################..
..............x...*#
