6 22
**.*#..*..#.##.###**#*
.###..#*x.#*.#*...**.#
*.#*##*....***....#.*0
##*.##..*#*.#...***#.*
***.*##.*.###...*...*.
..*#####***#.#*#***#**
